#################################
#   #   #     #     #   #   #   #
# # # # ### ### ### # # # # # # #
# #   #   #     # #   #   #   # #
# ####### ##### # ### # # # # # #
# #     #   #     # #   #   #   #
# ### # ### ##### # ### # # # # #
# #   #   #   #     # #   #   # #
# # ##### ### ##### # ######### #
# #   #     #   #     # #       #
# ### ### ##### ##### # ### ### #
# #   #     # #   #     # #   # #
# # ##### ### ### ##### # ### # #
# #   #     # #     #     # # # #
# ### ### ### ##### ##### # # ###
# #   #     # #M  #   #     #   #
# # ##### ### # # ### ##### ### #
# #   #     # #   # #   #     # #
# ### ### ### ### # ### ##### # #
# #   #     #   #     #   #   # #
# # ##### ### # # ### ### ### # #
# #   #     # # # #     #   # # #
# ### ### ### ##### ### ### ### #
# #   #     # # #     #   #   # #
# # ##### ### # # ####### ### # #
# #   #     # #     #       #   #
# ### ### ### # ########### # # #
# #   #     #               # # #
# # ##### ### ############### # #
# # #         #               # #
# # ########################### #
#S#                             #
#################################