#################################
#################################
#################################
#################################
#################################
#################################
#################################
#################################
#################################
#################################
#################################
#################################
#################################
#################################
#################################
#################################
#################################
#################################
###############  M ##############
############### ## ##############
###########   #  # ##############
########### ####    #############
###########   ### # #############
######### ### ##    #############
######### #      # ##############
########    # ## # ##############
######## ##        ##############
########    # ###################
############# ###################
#############S###################
#################################
#################################
#################################