#################################
#S###############################
# ###############################
#   #############################
### #############################
### #############################
### #############################
### ##########        ###########
#       ######## #### ###########
# # ###               ###########
# # ### ##### ####### ###########
# #  ##    ## ####### ### #######
# ##    ## ## ####### #   #######
# ## # ###  #   #       #########
# ## # ####   #   #####    ######
#    # #  ### ############ ######
# ##   ## #   ############ ######
# #### #    # ###### # ### ######
# #### ## ### ###### # ### ######
# #### ## ### ######     # ######
#      ## ### ##########     ####
# # ## ## ### ############## ####
### ##                # # #  ####
### ##### ### ### ###       #####
### ##### ### ### ##### #########
###           ##            #####
######################## ########
######################## ########
########################     ####
############################ ####
############################ ####
############################M####
#################################