#################################
#                               #
# ############################# #
# #                             #
# # ################# ######### #
# # #             #           # #
# # # ####### ######### ##### # #
# # # # #   #     # #   #     # #
# # # # # # ##### # # ### ##### #
# # # #   # #   #   # #       # #
# # # # ### # # ### # ####### # #
# # # #   # # #   #   #       # #
# # # ### # # ### ##### ####### #
# # #     # # #       #     # # #
# # ####### # ####### ##### # # #
# # #   #   # #     #       # # #
# # # # ### # # # # ######### # #
# # # #   # # #M  #     #     # #
# # # ### # # ####### ### # # # #
# # # #   #   #     #   # # # # #
# # # # ### ##### # ### # ### # #
# # # #     #   # #   #       # #
# # # ####### # # ### ### ### # #
# # #       # # #   #   #   # # #
# # ####### # # ### ### ### # # #
# # #       # # #     #   #   # #
# # # ####### # ##### ### ### # #
#   # #       # #       #   # # #
# # # ####### # ####### ### # # #
# # #         #         #     # #
# # ########################### #
#S#                             #
#################################