#################################
#                               #
# ####### ##################### #
# #                             #
# # ################# ######### #
# # #             #           # #
# # # ####### ######### ##### # #
#   # # #   #     # #   #     # #
# # # # # # ##### # # ### ##### #
# # # #   # #   #   # #       # #
# # # # ### # # ### # ####### # #
# # # #   # # #   #   #       # #
# # # ### # # ### ##### ####### #
# # #     # # #       #     # # #
#   ####### # ####### ##### # # #
# # #   #   # #     #       # # #
# # # # ### # # # # ######### # #
# # # #   # # #M  #     #     # #
# # # ### # # ####### ### # # # #
# # # #   #   #     #   # # # # #
# #   # ### ##### # ### # ### # #
# # # #     #   # #   #       # #
# # # ####### # # ### ### ### # #
# # #       # # #   #   #   # # #
# # ####### # # ### ### ### # # #
# # #       # # #     #   #   # #
# # # ####### # ##### ### ### # #
#   # #       # #       #   # # #
# # # ####### # ####### ### # # #
# # #         #         #     # #
# # ############### ########### #
#S#                             #
#################################